        99 0 ACT0 0 0 0x0000
       100 0 ACT1 0 0 0x0000
       138 0  RD0 0 0 0x0000
       139 0  RD1 0 0 0x0000
       154 0  WR0 0 0 0x0001
       155 0  WR1 0 0 0x0001
       231 0  PRE 0 0
       269 0 ACT0 0 0 0x3FFF
       270 0 ACT1 0 0 0x3FFF
       308 0  RD0 0 0 0x0003
       309 0  RD1 0 0 0x0003
