        99 0 ACT0 0 0 0x0000
       100 0 ACT1 0 0 0x0000
       138 0  RD0 0 0 0x0000
       139 0  RD1 0 0 0x0000
       180 0  RD0 0 0 0x0001
       181 0  RD1 0 0 0x0001
       199 0  PRE 0 0
       237 0 ACT0 0 0 0x3FFF
       238 0 ACT1 0 0 0x3FFF
       276 0  RD0 0 0 0x0003
       277 0  RD1 0 0 0x0003
