        99 0 ACT0 0 0 0x0000
       100 0 ACT1 0 0 0x0000
       138 0  WR0 0 0 0x0000
       139 0  WR1 0 0 0x0000
       186 0  WR0 0 0 0x0001
       187 0  WR1 0 0 0x0001
       263 0  PRE 0 0
       301 0 ACT0 0 0 0x3FFF
       302 0 ACT1 0 0 0x3FFF
       340 0  WR0 0 0 0x0003
       341 0  WR1 0 0 0x0003
