        99 0 ACT0 0 0 0x0000
       100 0 ACT1 0 0 0x0000
       138 0  WR0 0 0 0x0000
       139 0  WR1 0 0 0x0000
       208 0  RD0 0 0 0x0001
       209 0  RD1 0 0 0x0001
       227 0  PRE 0 0
       265 0 ACT0 0 0 0x3FFF
       266 0 ACT1 0 0 0x3FFF
       304 0  RD0 0 0 0x0003
       305 0  RD1 0 0 0x0003
