         0 0 ACT0 0 0 0x0000
         1 0 ACT1 0 0 0x0000
        12 0 ACT0 0 1 0x0000
        13 0 ACT1 0 1 0x0000
        24 0 ACT0 0 2 0x0000
        25 0 ACT1 0 2 0x0000
        36 0 ACT0 0 3 0x0000
        37 0 ACT1 0 3 0x0000
        39 0  RD0 0 0 0x0000
        40 0  RD1 0 0 0x0000
        51 0  RD0 0 1 0x0000
        52 0  RD1 0 1 0x0000
        63 0  RD0 0 2 0x0000
        64 0  RD1 0 2 0x0000
        75 0  RD0 0 3 0x0000
        76 0  RD1 0 3 0x0000
       100 0 ACT0 3 0 0x0000
       101 0 ACT1 3 0 0x0000
       112 0 ACT0 3 1 0x0000
       113 0 ACT1 3 1 0x0000
       124 0 ACT0 3 2 0x0000
       125 0 ACT1 3 2 0x0000
       136 0 ACT0 3 3 0x0000
       137 0 ACT1 3 3 0x0000
       139 0  RD0 3 0 0x0000
       140 0  RD1 3 0 0x0000
       151 0  RD0 3 1 0x0000
       152 0  RD1 3 1 0x0000
       163 0  RD0 3 2 0x0000
       164 0  RD1 3 2 0x0000
       175 0  RD0 3 3 0x0000
       176 0  RD1 3 3 0x0000
       200 0 ACT0 6 0 0x0000
       201 0 ACT1 6 0 0x0000
       212 0 ACT0 6 1 0x0000
       213 0 ACT1 6 1 0x0000
       224 0 ACT0 6 2 0x0000
       225 0 ACT1 6 2 0x0000
       236 0 ACT0 6 3 0x0000
       237 0 ACT1 6 3 0x0000
       239 0  RD0 6 0 0x0000
       240 0  RD1 6 0 0x0000
       251 0  RD0 6 1 0x0000
       252 0  RD1 6 1 0x0000
       263 0  RD0 6 2 0x0000
       264 0  RD1 6 2 0x0000
       275 0  RD0 6 3 0x0000
       276 0  RD1 6 3 0x0000
