        99 0 ACT0 0 0 0x0000
       100 0 ACT1 0 0 0x0000
       138 0  WR0 0 0 0x0000
       139 0  WR1 0 0 0x0000
       215 0  PRE 0 0
       216 0 ACT0 1 1 0x0001
       217 0 ACT1 1 1 0x0001
       255 0  WR0 1 1 0x0001
       256 0  WR1 1 1 0x0001
       332 0  PRE 1 1
