        99 0 ACT0 0 0 0x0000
       100 0 ACT1 0 0 0x0000
       138 0  RD0 0 0 0x0000
       139 0  RD1 0 0 0x0000
       176 0  PRE 0 0
       177 0 ACT0 1 1 0x0001
       178 0 ACT1 1 1 0x0001
       216 0  RD0 1 1 0x0001
       217 0  RD1 1 1 0x0001
       254 0  PRE 1 1
