        99 0 ACT0 0 0 0x0000
       100 0 ACT1 0 0 0x0000
       111 0 ACT0 0 1 0x0000
       112 0 ACT1 0 1 0x0000
       138 0  WR0 0 0 0x0000
       139 0  WR1 0 0 0x0000
       186 0  WR0 0 1 0x0000
       187 0  WR1 0 1 0x0000
