        99 0 ACT0 0 0 0x0000
       100 0 ACT1 0 0 0x0000
       107 0 ACT0 1 0 0x0000
       108 0 ACT1 1 0 0x0000
       138 0  RD0 0 0 0x0000
       139 0  RD1 0 0 0x0000
       146 0  RD0 1 0 0x0000
       147 0  RD1 1 0 0x0000
