        99 0 ACT0 0 0 0x0000
       100 0 ACT1 0 0 0x0000
       111 0 ACT0 0 1 0x0000
       112 0 ACT1 0 1 0x0000
       138 0  RD0 0 0 0x0000
       139 0  RD1 0 0 0x0000
       150 0  RD0 0 1 0x0000
       151 0  RD1 0 1 0x0000
       162 0  RD0 0 0 0x0000
       163 0  RD1 0 0 0x0000
