        99 0 ACT0 0 0 0x0000
       100 0 ACT1 0 0 0x0000
       107 0 ACT0 1 0 0x0000
       108 0 ACT1 1 0 0x0000
       138 0  WR0 0 0 0x0000
       139 0  WR1 0 0 0x0000
       146 0  WR0 1 0 0x0000
       147 0  WR1 1 0 0x0000
