         1 0 ACT0 0 0 0x0000
         2 0 ACT1 0 0 0x0000
        40 0  RD0 0 0 0x0000
        41 0  RD1 0 0 0x0000
        78 0  PRE 0 0
       116 0 ACT0 0 0 0x0001
       117 0 ACT1 0 0 0x0001
       155 0  WR0 0 0 0x0000
       156 0  WR1 0 0 0x0000
       225 0  RD0 0 0 0x0001
       226 0  RD1 0 0 0x0001
