         1 0 ACT0 0 0 0x0000
         2 0 ACT1 0 0 0x0000
        40 0  RD0 0 0 0x0000
        41 0  RD1 0 0 0x0000
        56 0  WR0 0 0 0x0000
        57 0  WR1 0 0 0x0000
       126 0  RD0 0 0 0x0000
       127 0  RD1 0 0 0x0000
