         1 0 ACT0 0 0 0x0000
         2 0 ACT1 0 0 0x0000
        13 0 ACT0 0 1 0x0000
        14 0 ACT1 0 1 0x0000
        25 0 ACT0 0 2 0x0000
        26 0 ACT1 0 2 0x0000
        37 0 ACT0 0 3 0x0000
        38 0 ACT1 0 3 0x0000
        40 0  RD0 0 0 0x0000
        41 0  RD1 0 0 0x0000
        52 0  RD0 0 1 0x0000
        53 0  RD1 0 1 0x0000
        64 0  RD0 0 2 0x0000
        65 0  RD1 0 2 0x0000
        76 0  RD0 0 3 0x0000
        77 0  RD1 0 3 0x0000
       101 0 ACT0 3 0 0x0000
       102 0 ACT1 3 0 0x0000
       113 0 ACT0 3 1 0x0000
       114 0 ACT1 3 1 0x0000
       125 0 ACT0 3 2 0x0000
       126 0 ACT1 3 2 0x0000
       137 0 ACT0 3 3 0x0000
       138 0 ACT1 3 3 0x0000
       140 0  RD0 3 0 0x0000
       141 0  RD1 3 0 0x0000
       152 0  RD0 3 1 0x0000
       153 0  RD1 3 1 0x0000
       164 0  RD0 3 2 0x0000
       165 0  RD1 3 2 0x0000
       176 0  RD0 3 3 0x0000
       177 0  RD1 3 3 0x0000
       201 0 ACT0 6 0 0x0000
       202 0 ACT1 6 0 0x0000
       213 0 ACT0 6 1 0x0000
       214 0 ACT1 6 1 0x0000
       225 0 ACT0 6 2 0x0000
       226 0 ACT1 6 2 0x0000
       237 0 ACT0 6 3 0x0000
       238 0 ACT1 6 3 0x0000
       240 0  RD0 6 0 0x0000
       241 0  RD1 6 0 0x0000
       252 0  RD0 6 1 0x0000
       253 0  RD1 6 1 0x0000
       264 0  RD0 6 2 0x0000
       265 0  RD1 6 2 0x0000
       276 0  RD0 6 3 0x0000
       277 0  RD1 6 3 0x0000
