         0 0 ACT0 0 0 0x0000
         1 0 ACT1 0 0 0x0000
        39 0  RD0 0 0 0x0000
        40 0  RD1 0 0 0x0000
        77 0  PRE 0 0
       115 0 ACT0 0 0 0x0001
       116 0 ACT1 0 0 0x0001
       154 0  WR0 0 0 0x0000
       155 0  WR1 0 0 0x0000
       192 0  PRE 0 0
       230 0 ACT0 0 0 0x0001
       231 0 ACT1 0 0 0x0001
       269 0  RD0 0 0 0x0001
       270 0  RD1 0 0 0x0001
