         0 0 ACT0 0 0 0x0000
         1 0 ACT1 0 0 0x0000
         8 0 ACT0 1 1 0x0000
         9 0 ACT1 1 1 0x0000
        39 0  RD0 0 0 0x0000
        40 0  RD1 0 0 0x0000
        47 0  RD0 1 1 0x0000
        48 0  RD1 1 1 0x0000
        55 0  RD0 0 0 0x0001
        56 0  RD1 0 0 0x0001
