         0 0 ACT0 0 0 0x0000
         1 0 ACT1 0 0 0x0000
        39 0  RD0 0 0 0x0000
        40 0  RD1 0 0 0x0000
        51 0  RD0 0 0 0x0000
        52 0  RD1 0 0 0x0000
        67 0  WR0 0 0 0x0000
        68 0  WR1 0 0 0x0000
