         1 0 ACT0 0 0 0x0000
         2 0 ACT1 0 0 0x0000
        13 0 ACT0 0 1 0x0001
        14 0 ACT1 0 1 0x0001
        40 0  RD0 0 0 0x0000
        41 0  RD1 0 0 0x0000
        52 0  RD0 0 1 0x0000
        53 0  RD1 0 1 0x0000
        64 0  RD0 0 0 0x0001
        65 0  RD1 0 0 0x0001
