         1 0 ACT0 0 0 0x0000
         2 0 ACT1 0 0 0x0000
         9 0 ACT0 1 0 0x0001
        10 0 ACT1 1 0 0x0001
        40 0  RD0 0 0 0x0000
        41 0  RD1 0 0 0x0000
        48 0  RD0 1 0 0x0000
        49 0  RD1 1 0 0x0000
        56 0  RD0 0 0 0x0001
        57 0  RD1 0 0 0x0001
