         0 0 ACT0 0 0 0x0000
         1 0 ACT1 0 0 0x0000
        12 0 ACT0 0 1 0x0001
        13 0 ACT1 0 1 0x0001
        39 0  RD0 0 0 0x0000
        40 0  RD1 0 0 0x0000
        51 0  RD0 0 1 0x0000
        52 0  RD1 0 1 0x0000
        63 0  RD0 0 0 0x0001
        64 0  RD1 0 0 0x0001
